age,total,2020,2021,2022,2023
total,5680,0,0,4874,806
0-9,9,0,0,6,3
10-19,4,0,0,3,1
20-29,15,0,0,12,3
30-39,34,0,0,30,4
40-49,109,0,0,93,16
50-59,298,0,0,264,34
60-69,708,0,0,606,102
70-79,1176,0,0,1004,172
80-89,1988,0,0,1705,283
90-99,1339,0,0,1151,188
100+,0,0,0,0,0
